1984 by George Orwell
The Lord of the Rings by J.R.R. Tolkien
The Kite Runner by Khaled Hosseini
Harry Potter and the Philosopher’s Stone by J.K. Rowling
Slaughterhouse-Five by Kurt Vonnegut
The Lion, the Witch, and the Wardrobe by C.S. Lewis
To Kill a Mockingbird by Harper Lee
Think and Grow Rich by Napoleon Hill
Far from the Madding Crowd: Thomas Hardy	
Discovery of India: Pandit Jawaharlal Nehru
Pilgrim’s Progress: From This World to That Which Is to Come: John Bunyan 	
My Experiments with Truth: Mahatma M.K.Gandhi
The Merchant of Venice: Shakespeare
Antony and Cleopatra: Shakespeare
A Tale of Two Cities – Charles Dickens
David Copperfield – Charles Dickens
Utopia: Sir Thomas Moor	
Origin of Species: Charles Darwin
Crime and Punishment: Dostoevsky
Das Kapital : Karl Marx
Chitra: R.N.Tagore	
Count of Monte Cristo: Alexander Dumas
Bisarjan: R.N.Tagore	
Canterbury Tales: Chaucer
Divine Comedy: Dante	
The Wild Iris: Louis Gluck
Baburnama: Babur	
Anna Karenina: Leo Tolstoy
Arthashastra: Kautilya	
Pride and Prejudice: Jane Austen